====  =====  ====
= .=............=
=...............=
=.... === .===..=
...=.  =  ...=...
...==  =  ...=...
=..=.  == ...=..=
=..=...=.....=..=
.............=...
.........==..=...
====  =====  ====