====  =====  ===
= =............=
=.....===..==..=
=..=.  .  .=...=
...=.  =  ==....
...==  =  .=....
=..=.  .  .=...=
=..=..=.=....=.=
=......=.....=.=
..........=..=..
====  =====  ===