==== =====  ===
=             =
=     ===     =
=  =       =  =
   =   =   =   
   =       =   
=  =   =   =  =
=  =       =  =
=......=      =
==== =====  ===